111111111111111
130222212222031
101111000111101
121002212200121
121021111120121
101002020200101
102210101012201
110112020211011
102210101012201
101002020200101
121021111120121
121002212200121
101111000111101
130222212222031
111111111111111
