111111111111111
130121202121031
121000212000121
122012111210221
121100212001121
100201202102001
111011101110111
122002202200221
111011101110111
100201202102001
121100212001121
122012111210221
121000212000121
130121202121031
111111111111111
