111111111111111
130122121221031
102122121221201
110201000102011
100000101000001
122102101201221
122101101101221
111000000000111
122101101101221
122102101201221
100000101000001
110201000102011
102122121221201
130122121221031
111111111111111
