111111111111111
130202212202031
101212212212101
122100000001221
101001212100101
122012000210221
122020121020221
111010222010111
122020121020221
122012000210221
101001212100101
122100000001221
101212212212101
130200012202031
111111111111111
