111111111111111
100210222012001
101020010020101
120221010122021
112212010212211
100121222121001
120000121200021
121112202211121
120002121200021
100121222121001
112212010212211
120221010122021
101020010020101
100210222012001
111111111111111
