111111111111111
100221000122001
101122202221101
122012101210221
120110101011021
121002212200121
121211010112121
100210202012001
121211010112121
121002212200121
120110101011021
122012101210221
101122202221101
100221000122001
111111111111111
