111111111111111
100202020202001
101010111010101
121202212200121
101101111101101
121200212002121
101011000110101
120202020202021
101011000110101
121200212002121
101101111101101
121002212200121
101010111010101
100202020202001
111111111111111
