111111111111111
100222222222001
101121212121101
122001010100221
122101010101221
121200010002121
122101111101221
122202212200221
122101111101221
121200010002121
122101010101221
122001010100221
101121212121101
100222222222001
111111111111111
